++++++++++++++++++++++
+   +   +  ++        +
      +   ++  ++++++++
+ +    ++  ++++ +++ ++
+ +   + + ++    +++  +
+          ++ -++  + +
+++++-+ +      ++  + +
+++++-+++ -+ +  ++   +
+          + + S+ +  +
+++++-+  + + +     + +
++++++++++++++++++++++
